NO ./xpm/brick.xpm
SO ./xpm/brick.xpm
WE ./xpm/brick.xpm
EA ./xpm/brick.xpm

F 255, 255, 204
C 51, 153, 255

111111111111111111111111
101011110110000000000001
100000111000000000111101
101010111111000000010001
100000000100000001110001
100000100000000011111001
1000000000000000010011N1
111111111111111111111111
